(3+1)-dimensional	adj
2-dimensional	adj
3D	adj
a posteriori	adj
a priori	adj
abatement	noun
abdominal	adj
abduction	noun
aberrant	adj
abiogenesis	noun
ablation	noun
abolutism	noun
aboveground	adj
absolute	adj
absorptivity	noun
absurdism	noun
abundance	noun
abundant	adj
acanthonotozomatid	noun
accessory	adj
accidentialism	noun
accombination	noun
accommodation	noun
accretion	noun
accumulator	noun
acetylcholinesterase	noun
acidic	adj
acidosis	noun
acnathosis	noun
acoelomate	adj
acosmism	noun
acoustic	adj
acrylic	adj
actinium	noun
actinium-based	adj
actinium-dependent	adj
actinometry	noun
activity-dependent	adj
actuality	noun
actuation	noun
acute	adj
ad hoc	adj
AdaBoost	noun
adaptable	adj
adapting	adj
adaptive	adj
addictive	adj
addressable	adj
adducts	noun
adenoid	adj
adenoma	noun
adenomatous	adj
adherent	adj
adhesion	noun
adhocracy	noun
adiabatic	adj
adipose	adj
administration	noun
advection	noun
advective	adj
aerial	adj
aerobic	adj
aerodynamic	adj
aerolite	noun
aestheticism	noun
affinity	noun
afocal	adj
ageing	noun
aggregator	noun
aggressive	adj
agile	adj
aging	noun
agitated	adj
agnosticism	noun
agonist	noun
agricultural	adj
agrotechnological	adj
agrotechnology	noun
AIDS	noun
alarming	adj
alarmone	noun
albedo	noun
alchemical	adj
algal	adj
algebraic	adj
aliasing	noun
alignment	noun
alkali	adj
alkaline	adj
alkaptonuria	noun
all-consuming	adj
allele	noun
allopatric	adj
allospecific	adj
allostasis	noun
allosteric	adj
alloy	noun
alluvium	noun
alpha	adj
altered	adj
alternating	adj
alternator	noun
altruism	noun
aluminium	noun
aluminium-based	adj
aluminium-dependent	adj
alveolar	adj
amblyopia	noun
americium	noun
americium-based	adj
americium-dependent	adj
ammonia-permeable	adj
ammonites	noun
ammonitic	adj
amortisation	noun
ampacity	noun
amphoteric	adj
amplification	noun
amplified	adj
amplitudes	noun
amyloidosis	noun
anacoustic	adj
anaerobic	adj
analemma	noun
analog	adj
analog-to-digital	adj
analogue	noun
analysis	noun
analytics	noun
anarchism	noun
Anarcho-primitivism	noun
Anarcho-syndicalism	noun
ancestral	adj
android	noun
androids	noun
anencephaly	noun
aneroid	noun
angular	adj
animal models	noun
Animism	noun
anisotrophy	noun
anisotropy	noun
annealing	noun
annelid	adj
annelids	noun
anodization	noun
anomaly	noun
anomic	adj
anomie	noun
ant colonies	noun
antecedent	noun
antenna array	noun
anterior	adj
Anthropocene	adj
Anthropocentrism	noun
anthropogenic	adj
Anthropomorphism	noun
anti-aliasing	noun
Anti-realism	noun
anti-tubercular	adj
antibacterial	adj
anticoagulant	noun
anticoagulation	noun
anticodon	noun
antidote	noun
antifragile	adj
antigravity	noun
antimatter	noun
antimony	noun
antimony-based	adj
antimony-dependent	adj
antineutron	noun
Antinomianism	noun
antiparticles	noun
antiretroviral	adj
antiviral	adj
aperiodic	adj
aperture	noun
apices	noun
apnea	noun
apoptosis	noun
app	noun
app-enabled	adj
apparatus	noun
appendage	noun
approach	noun
approximation	noun
aqueous	adj
Arabidopsis	adj
Arabidopsis	noun
arbitrage	noun
archaea	noun
archaeon	noun
Archean	adj
architecture	noun
archive	noun
archives	noun
arciform	adj
argon	noun
argon-based	adj
argon-dependent	adj
Aristotelianism	noun
Arminianism	noun
aRNA	noun
aromaticity	noun
array	noun
arrhythmia	noun
arsenic	noun
arsenic-based	adj
arsenic-dependent	adj
arthropod	adj
arthropod	noun
artificial	adj
artiodactyl	adj
artiodactyls	noun
Asceticism	noun
ascovirus	noun
asexual	adj
aspect	noun
Aspergillus	adj
Aspergillus	noun
Aspergillus fumigatus	adj
Aspergillus fumigatus	noun
assay	noun
assays	noun
assembling	adj
assembly	noun
assembly	adj
astatine	noun
astatine-based	adj
astatine-dependent	adj
asteroid	noun
astrobiological	adj
asymptotic	adj
Atheism	noun
atherectomy	noun
atomic	adj
atomic force	adj
Atomism	noun
atomistic	adj
atrial	adj
attainment	noun
attention span	noun
attentive	adj
attenuated	adj
attributed	adj
audacious	adj
austenitization	noun
autarky	noun
Authoritarianism	noun
authorities	noun
authority	noun
autism	noun
autism-associated	adj
autocatalytic	adj
autoimmune	adj
autoimmunity	noun
automatic	adj
Automatism	noun
automaton	noun
automatons	noun
autonomic	adj
autonomous	adj
autophagy	noun
autoradiography	noun
autozygosity	noun
available	adj
avatar	noun
avatars	noun
aviadenovirus	noun
avian	adj
awe-inspiring	adj
axiomatic	adj
axion	noun
axisymmetric	adj
azimuth	noun
B-splines	noun
bacillaemia	noun
Bacillus subtilis	adj
Bacillus subtilis	noun
bacteraemia	noun
bacteria	noun
bacteriophage	noun
bagasse	noun
balance	noun
ballistic	adj
ballistic	adj
bar	noun
barium	noun
barium-based	adj
barium-dependent	adj
barometric	adj
bartering	noun
baryogenesis	noun
baryonic	adj
basal	adj
baseline	adj
baselines	noun
basic	adj
basilar	adj
basis	noun
bathymetric	adj
beamforming	noun
beamlet	noun
behavior	noun
Behavioralism	noun
Behaviorism	noun
benchmark	noun
benthic	adj
berkelium	noun
berkelium-based	adj
berkelium-dependent	adj
beryllium	noun
beryllium-based	adj
beryllium-dependent	adj
best practices	noun
beta	adj
beta	adj
bewildering	adj
bias-inducing	adj
bibliometric	adj
bicameral	adj
bilocation	noun
bioavailable	adj
biobank	noun
biobanking	noun
biobanks	noun
biocatalytic	adj
biocompatibility	noun
biocompatible	adj
biocomplexity	noun
biocuration	noun
biodegradable	adj
bioethics	noun
biofilm	noun
biofuel	noun
biofuels	noun
biogeochemical	adj
biomass	noun
biomimetic	adj
bionic	adj
biophysical	adj
biopsychosocial	adj
bioreactor	noun
bioreactors	noun
bioregional	adj
biostatistics	noun
biosurveillance	noun
biotechnology	adj
bipartite	adj
bipartitioned	adj
bipartitioning	noun
bismuth	noun
bismuth-based	adj
bismuth-dependent	adj
blockchain	noun
bloom	noun
blot	noun
bohrium	noun
bohrium-based	adj
bohrium-dependent	adj
bolide	noun
bombardment	noun
Boolean	adj
bootstrapping	noun
boreal	adj
boron	noun
boron-based	adj
boron-dependent	adj
Bose-Einstein condensate	noun
bottom-up	adj
brachial	adj
brachytherapy	noun
bradycardia	noun
brain-computer interface	noun
branchial	adj
broad-spectrum	adj
broadband	adj
bromine	noun
bromine-based	adj
bromine-dependent	adj
bronchial	adj
Brownian	adj
bubbles	noun
buccal	adj
buckling	noun
budding	noun
budding	adj
buffalo	adj
bundle	noun
C	noun
C-terminal	adj
C#	noun
C++	noun
cache-enabled	adj
cadmium	noun
cadmium-based	adj
cadmium-dependent	adj
caesium	noun
caesium-based	adj
caesium-dependent	adj
calcifer	noun
calcifers	noun
calcium	noun
calcium-based	adj
calcium-dependent	adj
calculus	noun
californium	noun
californium-based	adj
californium-dependent	adj
cambium	noun
Campylobacter jejuni	noun
Campylobacter jejuni	adj
cancer	noun
cancerous	adj
cancers	noun
candidate	noun
candidates	noun
cannibalism	noun
capacitance	noun
capacitor	noun
capillary	noun
capsid	noun
carapace	noun
carbon	noun
carbon-based	adj
carbon-dependent	adj
carcinogenic	adj
carcinoma	noun
cardiovascular	adj
Cartesian	adj
Cartesianism	noun
cascades	noun
cascading	adj
catalyst	noun
catalysts	noun
catalytic	adj
cathode	adj
cathode	noun
cation	noun
Caulobacter crescentus	noun
Caulobacter crescentus	adj
causal	adj
causality	noun
causation	noun
cDNA	noun
cellular	adj
censored	adj
centifuge	noun
centrifuges	noun
centriole	noun
centroids	noun
centrosome	noun
ceratitic	adj
cerium	noun
cerium-based	adj
cerium-dependent	adj
challenges	noun
channel	noun
channelized	adj
channels	noun
chaperone	noun
characterizing	adj
chemoattractant	noun
chemoautotrophic	adj
chemosensory	adj
chemotactic	adj
chi	adj
chikungunya	adj
Chikungunya virus	noun
chimera	noun
chiral	adj
Chlamydomonas reinhardtii	adj
Chlamydomonas reinhardtii	noun
chlorine	noun
chlorine-based	adj
chlorine-dependent	adj
cholesteric	adj
chorea	noun
chrominance	noun
chromium	noun
chromium-based	adj
chromium-dependent	adj
chromosome	noun
chronic	adj
cichlid	noun
cichlids	noun
cilia	noun
ciliary	adj
circumfrentor	noun
circumvallate	adj
cis-regulatory	adj
clade	noun
cladistics	noun
classical	adj
classification	noun
clinical	adj
CLIP-ligation	noun
cloaking	noun
Clojure	noun
cloud-based	adj
clustering	adj
coalescence	noun
coalescent	adj
coarse-grained	adj
cobalt	noun
cobalt-based	adj
cobalt-dependent	adj
coccidian	adj
coccoid	adj
cochleae	noun
code	noun
codes	noun
coding	noun
coding sequence	noun
codon	noun
coefficients	noun
coenzyme	noun
coercion	noun
coercive	adj
cognitive	adj
coherence	noun
coherency	noun
coherent	adj
cohort	noun
coiled coils	noun
coleoid	adj
colitis	noun
collapse	noun
collective	adj
collider	noun
collision	noun
colorectal	adj
commensalism	noun
Communalism	noun
commutative	adj
comparative	adj
comparator	noun
compartment	noun
compartmentalization	noun
compiler	noun
complementary	adj
complex	adj
compliance	noun
compliant	adj
compressible	adj
compression	noun
computational	adj
computer-aided	adj
concept-based	adj
Conceptualism	noun
condensed	adj
confocal	adj
conformation	noun
conformational	adj
confounding	adj
congenital	adj
conical	adj
conjectural	adj
conjugate	adj
conjugated	adj
conjugation	noun
conjunctive	adj
connective	adj
conservation	noun
conspecific	adj
conspecifics	noun
conspicuous	adj
constancy	noun
constriction	noun
contagion	noun
contagions	noun
contaminated	adj
contexts	noun
contextual	adj
continuation	noun
contour	noun
contoured	adj
contract	noun
contractile	adj
contracture	noun
control	noun
controlled	adj
conventional	adj
Conventionalism	noun
convergence	noun
convergent	adj
convex	adj
convolutional	adj
cooperation	noun
cooperativity	noun
coordination	noun
copepods	noun
copernicium	noun
copernicium-based	adj
copernicium-dependent	adj
copper	noun
copper-based	adj
copper-dependent	adj
core	noun
coronal	adj
corpus	noun
correcting	adj
cortex	noun
cortical	adj
corundum 	noun
cosmic	adj
cosmological	adj
cosmology	noun
cotranslational	adj
counterexample	noun
counterexamples	noun
counterintuitive	adj
covalent	adj
CP-violation	noun
cranial	adj
crash	noun
creod	noun
CRISPR	noun
CRISPR-Cas	noun
cross-individual	adj
crosstalk	noun
crRNA	noun
crucible	noun
cryobiological	adj
cryogenic	adj
cryoglobulinemia	noun
cryostasis	noun
cryotomography	noun
cryptanalysis	noun
cryptographic	adj
cryptography	noun
crystalline-coil	adj
crystallizable	adj
CSMA/CA	noun
cubic	adj
cuboid	noun
curium	noun
curium-based	adj
curium-dependent	adj
curvature-induced	adj
curvilinear	adj
cutpoints	noun
cybersecurity	noun
cyborg	noun
cycle	noun
cyclic	adj
cyclotron	noun
Cynicism	noun
cystic	adj
cytokines	noun
cytomegaloviral	adj
cytomegalovirus	noun
cytonemes	noun
cytoplasm	noun
cytoplasmic	adj
cytoskeleton	noun
dacrocystitis	noun
Daphnia	adj
Daphnia	noun
Darcy–Weisbach	adj
dark	adj
darmstadtium	noun
darmstadtium-based	adj
darmstadtium-dependent	adj
Darwinian	adj
data	noun
data mining	noun
data stream	noun
data-driven	adj
database	noun
datum	noun
daunting	adj
de Bruijn graphs	noun
de novo	adj
death	noun
debris	noun
decadal	adj
decay	noun
decentralized	adj
decision-making	noun
decoding	noun
deconvolution	noun
Deductivism	noun
definite	adj
deforming	adj
degrees of freedom	noun
deleterious	adj
delta	adj
demographics	noun
demyelination	noun
dendric	adj
dendrites	noun
dendritic	adj
dependencies	noun
dependency	noun
deployment	noun
depolarization	noun
deposition	noun
derivative	adj
derivative	noun
derivatives	noun
descent	noun
descriptor	noun
design	noun
detecting	adj
detection	noun
deterministic	adj
detoxification	noun
detritivore	noun
detritivores	noun
detritivorous	adj
detyrosinated	adj
deuteron	noun
device	noun
Devonian	adj
diagnostics	noun
diaphoresis	noun
diaphragmatic	adj
diathesis	noun
differential	adj
differentiated	adj
diffuser	noun
diffusion	noun
digital	adj
dimensionless	adj
dimorphic	adj
dimorphism	noun
diode	noun
diphtheria	noun
diploid	adj
discontinuity	noun
discontinuous	adj
discourse	noun
discovery	noun
discrete	adj
discrimination	noun
disembodiment	noun
disequilibrium	noun
disjunctive	adj
disorder	noun
dispersion	noun
dispositional	adj
disquieting	adj
disruption	noun
disruptive	adj
disseminated	adj
dissemination	noun
dissipation	noun
dissipative	adj
dissociative	adj
dissolution	noun
distal	adj
distinct	adj
distortion	noun
distributed	adj
divalent	adj
dNTP	noun
dNTP synthesis	noun
docking	noun
dogma	noun
dogmatic	adj
domestication	noun
domical	adj
dominance	adj
dominant	adj
doping	noun
dorsal	adj
dorsoflexion	noun
double prime	adj
downlink	noun
downshock	adj
drainage	noun
DRM-enabled	adj
drone	noun
drones	noun
druggability	noun
duality	noun
dubnium	noun
dubnium-based	adj
dubnium-dependent	adj
ductile	adj
ductility	noun
duplex	adj
duricrust	noun
dwarf	adj
dyad	noun
dyads	noun
dyamics	noun
dynamic	adj
dynamical	adj
dynamics	noun
Dynamism	noun
dynein	noun
dysfunction	noun
dysphagia	noun
dysplasia	noun
dysprosium	noun
dysprosium-based	adj
dysprosium-dependent	adj
early-stage	adj
echoic	adj
echolocation	noun
ecohydrology	noun
ecological	adj
ecosphere	noun
ecosystem	noun
ecosystems	noun
ecotype	noun
ectodermal	adj
ectoparasite	noun
edema	noun
effector	noun
efferent	adj
effluent	noun
efflux	noun
eigenvalue	noun
eightfold	adj
einsteinium	noun
einsteinium-based	adj
einsteinium-dependent	adj
elastic	adj
elasticity	noun
electric	adj
electrochemical	adj
electrodermal	adj
electroluminescent	adj
electrolysis	noun
electrolytes	noun
electrolytic	adj
electromagnetic	adj
electron	noun
electron	adj
electrophoresis	noun
electroplating	noun
electroporated	adj
electroporation	noun
electroweak	adj
elusive	adj
embedded	adj
embedding	noun
embeddings	noun
emboli	noun
embryo	noun
emergent	adj
emergent materialism	noun
emission	noun
emitter	noun
empirical	adj
emulsion	noun
encapsulation	noun
encephalitis	noun
encephalopathy	noun
encoder	noun
encryption	noun
endergonic	adj
endocannabinoid	adj
endocrine	adj
endoderm	adj
endopericarditis	noun
endostyle	noun
endosymbiotic	adj
energetic	adj
engine	noun
engineering	noun
enoplasmic	adj
ensemble	adj
entailment	noun
entangled	adj
entanglement	noun
enterohepatic	adj
enterovirus	adj
enterovirus	noun
enterprise	noun
entity	noun
entomopathogenic	adj
entropic	adj
entry-competent	adj
enzymatic	adj
enzyme	noun
enzymes	noun
Eocene	adj
Epicureanism	noun
epidemic	adj
epidemic	noun
epidemiology	noun
epidermal	adj
epidermis	noun
epigenetic	adj
episodic	adj
epistatic	adj
epithelial	adj
epizoology	noun
epsilon	adj
equation	noun
eradication	noun
erbium	noun
erbium-based	adj
erbium-dependent	adj
erbium-doped	adj
erosion	noun
eruptive	adj
erysipelas	noun
Escherichia coli	adj
Escherichia coli	noun
estimated	adj
estimates	noun
estimating	adj
estimation	noun
estimators	noun
estuary	noun
eta	adj
ethical	adj
etiology	noun
eukaryotic	adj
europium	noun
europium-based	adj
europium-dependent	adj
evolution	noun
evolutionary	adj
ex vivo	adj
excellence	noun
excess	adj
excitability	noun
excitatory	adj
excited	adj
executable	adj
exome	noun
exoplanet	noun
exoplanets	noun
exosomal	adj
expansive	adj
expenditures	noun
explicit	adj
exponential	adj
exponentials	noun
exposure	noun
expulsion	noun
extending	adj
extensible	adj
external	adj
extinct	adj
extinction	noun
extinction	adj
extrasynaptic	adj
extravasation	noun
extrinsic	adj
Extropianism	noun
eyetracking	noun
facial	adj
facilitating	adj
factor	noun
facultative	adj
Faraday	adj
fascia	noun
fast-evolving	adj
fat-free	adj
feedback	noun
femoral	adj
Fermi-Hubbard	adj
fermium	noun
fermium-based	adj
fermium-dependent	adj
ferromagnetism	noun
ferrous	adj
fibrillation	noun
fibroblast	noun
fibroblasts	noun
fibrosis	noun
field	noun
field trials	noun
filament	noun
filamentous	adj
film	noun
filtration	noun
financial	adj
financial	adj
fingerprinting	noun
fixed-size	adj
flagellar	adj
flagellum	noun
flammable	adj
flange	noun
flaviviral	adj
flavivirus	noun
flerovium	noun
flerovium-based	adj
flerovium-dependent	adj
flipped	adj
flow	noun
fluidics	noun
fluidics	noun
Fluorescence In Situ Hybridization	noun
fluorescent	adj
fluorine	noun
fluorine-based	adj
fluorine-dependent	adj
fluoroquinolone	noun
flux	noun
flywheel	noun
folksonomy	noun
foo	noun
foraging	noun
forebrain	noun
formability	noun
Formalism	noun
FOSS	noun
fossil	noun
fossilized	adj
fovea	noun
fraction	noun
fractional	adj
fractionated	adj
framework	noun
Francisella tularensis	noun
Francisella tularensis	adj
francium	noun
francium-based	adj
francium-dependent	adj
Fraunhofer	adj
frenulum	noun
FRET-FLIM	noun
friction	noun
frictional	adj
frictionless	adj
frightening	adj
full	adj
full-fledged	adj
fullerene	adj
fullerene	noun
functional	adj
fundamental	adj
fungal	adj
fused	adj
fusion	noun
futile	adj
fuzzy logic	noun
G-protein	noun
gadolinium	noun
gadolinium-based	adj
gadolinium-dependent	adj
galactic	adj
galectin	noun
galectins	noun
gallium	noun
gallium-based	adj
gallium-dependent	adj
galvanic	adj
game theory	noun
gamification	noun
gamma	adj
gamma	adj
gamma-phase	adj
ganglia	noun
ganglion	noun
gas-phase	adj
gasification	noun
gastrorrhaphy	noun
gastrotomy	noun
gastrulation	noun
gauge	noun
Gaussian	adj
gearing	noun
gene cluster	noun
gene drive	noun
gene drives	noun
generalized	adj
generation	noun
genetic	adj
genetic element	noun
genomic	adj
genotyping	adj
geochemistry	noun
geodetic	adj
germ cell granule	noun
germanium	noun
germanium-based	adj
germanium-dependent	adj
gestalt	noun
giant	adj
GitHub	noun
glaucoma	noun
glioma	noun
gliotoxin	noun
globally-applicable	adj
globular	adj
globulovirus	noun
glottal	adj
glutamatergic	adj
gluteal	adj
glycobioinformatics	noun
glycolytic	adj
glycosome	noun
glycosylation site	noun
gold	noun
gold-based	adj
gold-dependent	adj
Golgi apparatus	noun
goniatitic	adj
gonococcal	adj
gonococcus	noun
gonorrhea	noun
gradient	noun
gradients	noun
graph	noun
graphene	adj
graphene	noun
graphlet	noun
graphlets	noun
graser	noun
gravitonics	noun
gravity	noun
gravity-driven	adj
gross	adj
groundwater	noun
group A Streptococcus	noun
group A Streptococcus	adj
groupthink	noun
GUIs	noun
gular	adj
GWAS	noun
gyrator	noun
gyrators	noun
Haar wavelets	noun
Haar-like	adj
habitat	noun
hadron	noun
hafnium	noun
hafnium-based	adj
hafnium-dependent	adj
halo	noun
haloarchaeon	noun
haploid	adj
haptic	adj
hardwired	adj
harmonic	adj
hassium	noun
hassium-based	adj
hassium-dependent	adj
hegemony	noun
helical	adj
Helicobacter pylori	noun
Helicobacter pylori	adj
helium	noun
helium-based	adj
helium-dependent	adj
helix	noun
helminth	adj
helminth	noun
hemagglutinin	noun
hemolymph	noun
hepatic	adj
hereditary	adj
hermeneutics	noun
herniation	noun
hetero-tetramers	noun
heterogeneous	adj
heterojunction	noun
heteropoiesis	noun
heteropolymer	noun
heuristic	adj
hierarchical	adj
high Q	adj
high-harmonic	adj
high-resolution	adj
high-throughput	adj
high-torque	adj
hindrance	noun
hippocampal	adj
histograms	noun
histological	adj
histology	noun
Histoplasma	adj
Histoplasma	noun
HIV	adj
holistic	adj
holmium	noun
holmium-based	adj
holmium-dependent	adj
holobiont	noun
holoenzyme	noun
hologenome	noun
hominid	adj
homogenous	adj
homoiohydry	noun
homologous	adj
homopolymer	noun
homotopy	noun
horizontal	adj
hot spot	noun
hot spots	noun
hoverboard	noun
hoverboards	noun
human-mediated	adj
hybrid	adj
hybridization	noun
hydraulic	adj
hydrocarbon	noun
hydrogel	noun
hydrogels	noun
hydrogen	noun
hydrogen-based	adj
hydrogen-dependent	adj
hydrophilic	adj
hydrophobic	adj
hydrosphere	noun
hydrostat	noun
hydroxyapatite	noun
hydroxyprolinemia	noun
Hylozoism	noun
hyperexpansion	noun
hypergraph	noun
hyperspatial	adj
hyperspectral	adj
hypertension	noun
hypertensive	adj
hypertoxinogenic	adj
hypertrophic	adj
hypoendemic	adj
hypoeutectoid	adj
hypohidrotic	adj
hypopituitarism	noun
hypothetical	adj
hypoxia	noun
hypoxia-inducible	adj
hysteresis	noun
iconographic	adj
ideal	adj
idiopathic	adj
illumination	noun
illusory	adj
imaging	noun
immunity	noun
immunomodulatory	adj
immunostimulating	adj
impedance	noun
impervious	adj
impetigo	noun
implicit	adj
imprinted	adj
in vitro	adj
in vivo	adj
inappropriate	adj
inapproximability	noun
incendiary	adj
incentives	noun
inclusions	noun
incubator	noun
indefinite	adj
index	noun
indices	noun
indirect	adj
indium	noun
indium-based	adj
indium-dependent	adj
individualisation	noun
induced	adj
induction	noun
inertia	noun
infarction	noun
infective	adj
inferior	adj
inferring	adj
infiltration	noun
infinite	adj
infinite-dimensional	adj
inflation	noun
influenza	noun
infonomics	noun
informativeness	noun
ingress	noun
inguinal	adj
injection-molded	adj
innovation	noun
innovative	adj
inoculum	noun
inorganic	adj
instance-dependent	adj
institution	noun
institutional	adj
insulin	noun
insulin-like	adj
integrative	adj
integrity	noun
integument	noun
intel	noun
intelligence	noun
inter-species	adj
interacting	adj
interaction	noun
interactions	noun
interactive	adj
interactome	noun
interference	noun
intermediate	adj
intermediate	adj
intermittent	adj
intermodulation	noun
interneurons	noun
interoception	noun
interruption	noun
interspecific	adj
interspersed	adj
intervalometer	noun
intervention	noun
intimidating	adj
intra-class	adj
intracell	adj
intracellular	adj
intracranial	adj
intramembrane	adj
intratumor	adj
intrinsic	adj
introgression	adj
intrusion	noun
intussusception	noun
invariance	noun
inverse	adj
inversion	noun
inverted	adj
iodine	noun
iodine-based	adj
iodine-dependent	adj
ion channel	noun
ion channels	noun
ionic	adj
ionization	noun
ionotropic	adj
iota	adj
iPSCs	noun
iridium	noun
iridium-based	adj
iridium-dependent	adj
iron	noun
iron-based	adj
iron-dependent	adj
Irrealism	noun
irreducible	adj
irregular	adj
isomorph	noun
isopod	noun
isopods	noun
isospin	noun
isotonic	adj
isotope-sensitive	adj
isotopic	adj
itemset	noun
itemsets	noun
Java	noun
JavaScript	noun
judgments	noun
junction	noun
juvenile	adj
kaon	noun
kaons	noun
kappa	adj
Keras models	noun
keying	noun
keyphrase	noun
keyphrases	noun
killer	adj
kinase	noun
kinetics	noun
krypton	noun
krypton-based	adj
krypton-dependent	adj
Lab-On-a-Chip	noun
label-structured	adj
labyrinthine	adj
lag	noun
lambda	adj
lambda	adj
lambda-type	adj
laminae	noun
laminar	adj
lamination	noun
lampreys	noun
lanthanum	noun
lanthanum-based	adj
lanthanum-dependent	adj
laparoscopes	noun
Laplacian	adj
laser	noun
latency	noun
latent	adj
lateral	adj
lattice	noun
launch system	noun
lawrencium	noun
lawrencium-based	adj
lawrencium-dependent	adj
lead	noun
lead-based	adj
lead-dependent	adj
leakage	noun
learning-to-rank	noun
lensing	noun
lentiviral	adj
lepidopteran	noun
lepidopteran	adj
leukocytes	noun
leverage	noun
lexical	adj
lexicon	noun
LiDAR	noun
lifespans	noun
ligase	noun
ligases	noun
ligation	noun
light-dependent	adj
light-field	noun
likelihood	noun
lipophilic	adj
lipoplasty	noun
liposome	noun
liquid	adj
Lisp	noun
lithium	noun
lithium-based	adj
lithium-dependent	adj
lithotripsy	noun
livermorium	noun
livermorium-based	adj
livermorium-dependent	adj
local	adj
locomotion	noun
locus	noun
logistics	noun
long-tail	adj
longevity	noun
longitudinal	adj
lossless	adj
lossy	adj
lousy	adj
lubricated	adj
luciferase	noun
luciferase-tagged	adj
lumbar	adj
luminescent	adj
lutetium	noun
lutetium-based	adj
lutetium-dependent	adj
lymphangiectasis	noun
lymphoproliferative	adj
lymphovenous	adj
lysate	noun
lysates	noun
lysosome	noun
lysosomotropic	adj
macro-algae	noun
macrocephaly	noun
macroevolution	noun
macromolecular	adj
macromolecule	noun
macronutrients	noun
macrophage	noun
macropinocytosis	noun
magnesium	noun
magnesium-based	adj
magnesium-dependent	adj
magnetic	adj
magnetocrystalline	adj
magnetohydrodynamic	adj
Maize	adj
Maize	noun
malaria	adj
malaria	noun
malicious	adj
malleable	adj
mammalian	adj
mammary	adj
manganese	noun
manganese-based	adj
manganese-dependent	adj
manifold	adj
manifold	noun
many-to-one	adj
Markov chain	noun
Markov model	noun
markup	noun
martensitic	adj
maser	noun
mass	noun
massive	adj
massless	adj
massless	adj
mate choice	noun
maternal	adj
matrix	noun
matter	noun
maximizing	adj
mechanics	noun
mechanism	noun
mechanistic	adj
mechanophores	noun
mediation	noun
medulla	noun
megadiverse	adj
meitnerium	noun
meitnerium-based	adj
meitnerium-dependent	adj
melanoma	noun
melanomagenesis	noun
melatonin	noun
meltdown	noun
membrane-bound	adj
memories	noun
memory	noun
memristor	noun
mendelevium	noun
mendelevium-based	adj
mendelevium-dependent	adj
meningococcal	adj
mercury	noun
mercury-based	adj
mercury-dependent	adj
merozoites	noun
MERS coronavirus	adj
MERS coronavirus	noun
mesh	noun
mesosome	noun
metabolic	adj
metabolites	noun
metacarpointerphalangeal	adj
metaglycome	noun
metaheuristics	noun
metaproteome	noun
metaproteomics	noun
metastasis	noun
metastatic	adj
metazoan	adj
methanogenesis	noun
method	noun
methodology	noun
methods	noun
Methuselah	adj
methylated	adj
methylation	noun
micelles	noun
microalgal	adj
microbial mat	noun
microbiology	noun
microbiome	noun
microbioreactor	noun
microenvironment	noun
microenvironment-derived	adj
microfossils	noun
microinjected	adj
microinjection	noun
microkinetic	adj
micronutrient	noun
micronutrients	noun
microrheology	noun
microscopy	noun
microstrip	adj
microtuble	noun
microtubule-organizing center	noun
microvessels 	noun
microvilli	noun
microvoid	noun
microvoids	noun
middleware	adj
middleware	noun
midline	adj
migration	noun
military-grade	adj
mimic	adj
mimic	noun
mimicry	noun
minimal-interval	adj
misfolding	noun
misperception	noun
misspecification	noun
mitochondrial	adj
mitogenome	noun
mitogenomics	noun
mode of action	noun
mode-locking	noun
model	noun
models	noun
modulation	noun
modulus	noun
molecular	adj
molecular-scale	adj
molecule	noun
molybdenum	noun
molybdenum-based	adj
molybdenum-dependent	adj
momentum	noun
monad	noun
mongoose	noun
monodisperse	adj
monodromy	noun
monoenergetic	adj
monophyly	noun
monoterpenoid	adj
moonlighting	adj
moonlighting	noun
moorlands	noun
moral relativism	noun
morbidity	noun
morphology	noun
morphology-controlled	adj
morphometry	noun
motile	adj
motility	noun
mRNA	noun
mRNAs	noun
MRSA	noun
mu	adj
mucociliary	adj
mucosa	noun
mucus	noun
muliplex	adj
multi-agent	adj
multi-behavioral	adj
multi-cell	adj
multi-ethnic	adj
multi-gigapixel	adj
multi-label	adj
multi-layer	adj
multi-level	adj
multi-modal	adj
multicast	adj
multicellular	adj
multicentre	adj
multileaving	adj
multilumen	adj
multiphoton	adj
multiplayer	adj
multiple-input	adj
multiple-input	noun
multiple-output	adj
multiple-output	noun
multiplex	adj
multiplexed	adj
multiplexing	noun
multistable	adj
multistakeholders	noun
multiuser	adj
multivariant	adj
multiverse	noun
multiwavelength	adj
mutation	noun
mutational	adj
mutations	noun
mutual	adj
mutualism	noun
myalgia	noun
mycobacteriophage	noun
Mycobacterium tuberculosis	adj
Mycobacterium tuberculosis	noun
Mycoplasma mobile	adj
Mycoplasma mobile	noun
myelination	noun
myocardial	adj
myometrium	noun
N-terminal	adj
nanoball	noun
nanobot	noun
nanocomposites	noun
nanocone	adj
nanocone	noun
nanocones	noun
nanoconfined	adj
nanocylinder	noun
nanometallurgy	noun
nanopore	noun
nanorod	noun
nanorods	noun
nanoscale	adj
nanostructure	noun
nanostructured	adj
nasal	adj
nasopalpebral	adj
near-IR	adj
nebulizer	noun
negative	adj
nematic	adj
nematocyst	noun
nematode	noun
nematodes	noun
neodymium	noun
neodymium-based	adj
neodymium-dependent	adj
neofunctionalization	noun
neon	noun
neon-based	adj
neon-dependent	adj
neonatal	adj
neoplasia	noun
neoplasm	noun
neoplasms	noun
neptunium	noun
neptunium-based	adj
neptunium-dependent	adj
network	noun
network-assisted	adj
neural	adj
neurocardiogenic	adj
neurocomputational	adj
neurodegenerative	adj
neuromechanics	noun
neuromuscular	adj
neuronal	adj
neuronal transport granule	noun
neuropathy	noun
neuroprosthetics	noun
Neurospora crassa	adj
Neurospora crassa	noun
neutral	adj
neutrino	noun
neutron	noun
news streams	noun
Newtonian	adj
next-generation	adj
nickel	noun
nickel-based	adj
nickel-based	adj
nickel-dependent	adj
niobium	noun
niobium-based	adj
niobium-dependent	adj
nitrogen	noun
nitrogen-based	adj
nitrogen-dependent	adj
nobelium	noun
nobelium-based	adj
nobelium-dependent	adj
nociception	noun
nociceptive	adj
node	noun
NodeJS	noun
noisy	adj
nomenclature	noun
non-coding RNAs	noun
non-homologous	adj
non-Mendelian	adj
non-obtuse	adj
nondeterministic	adj
nonessential	adj
nonlinear	adj
nonlinearity	noun
nonlocality	noun
nonpoint	adj
nonstochastic	adj
normalization	noun
norovirus	noun
novel	adj
noxious	adj
NP-hard	adj
nu	adj
nuclei	noun
nucleocapsid	noun
nucleosome	noun
nucleus	noun
nudivirus	noun
nullspace	noun
numerical	adj
nutating	adj
nutritional	adj
obese	adj
object-oriented	adj
Objective-C	noun
oblivious	adj
obstructive	adj
occipital	adj
octahedral	adj
oesophagismus	noun
oestrogenic	adj
off-the-shelf	adj
offloading	noun
oil	noun
oils	noun
oleophilic	adj
olfaction	noun
olfactory	adj
oligodendrocyte	noun
oligomer	noun
oligomeric	adj
omega	adj
omicron	adj
omics	noun
omnidirectional	adj
one-dimensional	adj
ontological	adj
ontology	noun
oocyte	noun
open source	adj
open-access	adj
operator	noun
operators	noun
operculum	noun
opioid	adj
opportunism	noun
opportunistic	adj
optimal	adj
optimally doped	adj
optimized	adj
optimizing	adj
orbicular	adj
orbital	adj
orbitals	noun
ordered	adj
ores	noun
organelle	noun
organoid	noun
orientation	noun
oriented	adj
ornamentation	noun
orthogonal	adj
orthomorphisms	noun
oscillating	adj
oscillation	noun
oscillations	noun
oscillator	noun
oscillators	noun
osmium	noun
osmium-based	adj
osmium-dependent	adj
osmolarity	noun
osmoregulation	noun
osmosis	noun
osseointegration	noun
osteogenic	adj
ownership	noun
oximetric	adj
oximetry	noun
oxygen	noun
oxygen-based	adj
oxygen-dependent	adj
oxygenase	noun
oxygenation	noun
P-values	noun
pachymeningitis	noun
paleolitter	noun
paleontological	adj
Paleozoic	adj
paleozoology	noun
palindromic	adj
palladium	noun
palladium-based	adj
palladium-dependent	adj
Pancoast syndrome	noun
pandemic	adj
pandemic	noun
pangenome	noun
papillomavirus	noun
paradigm	noun
paradigms	noun
parallax	noun
parallel	adj
paramagnetic	adj
parameter	noun
parameterization	noun
parameterizations	noun
parameters	noun
paraphyletic	adj
parasite	noun
parasitic	adj
parent-child	adj
Pareto-optimal	adj
parietal	adj
parity	noun
particle	noun
partition	noun
parvovirus	noun
patch-clamp	noun
paternal	adj
pathobiology	noun
pathogenetic	adj
pathogenicity island	noun
pathogenicity islands	noun
pathological	adj
pathology	noun
pathway	noun
pectoral	adj
pegylated	adj
pelage	noun
pellicle	noun
pentameric	adj
pentaprisms	noun
peptide	noun
percept	noun
perception	noun
perceptive	adj
perceptron	noun
perceptual	adj
perchloric acid	noun
percolation	noun
percutaneous	adj
pericarp	noun
periodic	adj
periodicities	noun
peritectic	adj
permeable	adj
peroxidation	noun
peroxisome	noun
perpendicular	adj
persistence	noun
personalization	noun
personalized	adj
perturbed	adj
phage display	noun
pharmacogenomic	adj
pharmacology	noun
pharyngeal	adj
pharynx	noun
phenology	noun
phenomenological	adj
phenotype	noun
phlyctenular	adj
phosphate	noun
phosphates	noun
phosphoproteome	noun
phosphoproteomics	noun
phosphoproteomics-based	adj
phosphorus	noun
phosphorus-based	adj
phosphorus-dependent	adj
photoacoustic	adj
photobiomodulation	noun
photochemistry	noun
photoelectric	adj
photon-plasmon	noun
photovoltaic	adj
PHP	noun
phylogenetic	adj
phylogenomic	adj
phylotype	noun
pi	adj
piece-wise	adj
pigment	noun
pilus	noun
pipeline	noun
pipette	noun
pipettes	noun
pithovirus	noun
placenta	noun
placental	adj
planar	adj
planimetric	adj
planktonic	adj
plasmid	noun
Plasmodium	adj
Plasmodium	noun
Plasmodium	noun
plasticity	noun
plastron	noun
platelets	noun
platinum	noun
platinum-based	adj
platinum-dependent	adj
plenary	adj
pleolipovirus	noun
pleurodynia	noun
plume	noun
plumes	noun
pluripotency	noun
pluripotent	adj
plutonium	noun
plutonium-based	adj
plutonium-dependent	adj
pneumatic	adj
pneumatics	noun
poikilohydry	noun
point-of-care	adj
polar	adj
polarimetry	noun
pollination	noun
poloidal	adj
polonium	noun
polonium-based	adj
polonium-dependent	adj
polyamines	noun
polygenic	adj
polyhedra	noun
polyhedral	adj
polyhedron	noun
polymerase	noun
polymers	noun
polymorphic	adj
polymorphism	noun
polyploid	adj
polyploids	noun
polyposis	noun
polysome	noun
pooled	adj
porcine	adj
pore	noun
porous	adj
positional cloning	noun
post-buckling	noun
post-industrial	adj
post-transcriptional	adj
post-translational	adj
postcapillary	adj
postinfectious	adj
Postmodernism	noun
potassium	noun
potassium-based	adj
potassium-dependent	adj
potentiometer	noun
praseodymium	noun
praseodymium-based	adj
praseodymium-dependent	adj
precoding	noun
precognition	noun
predatory	adj
predicting	adj
predictive	adj
preferred	adj
prefilled	adj
preliminary	adj
prevalence	noun
prime	adj
primordial	adj
prion	noun
prions	noun
prismatic	adj
prisoner's dilemma	noun
privacy-aware	adj
privatisation	noun
privatization	noun
probabilistic	adj
probing	noun
process	noun
process	noun
processing	adj
processive	adj
processivity	noun
processome	noun
Procyon lotor	noun
Procyon lotor	adj
product	noun
products	noun
profile	noun
programmatic	adj
programme	noun
programs	noun
prokaryotic	adj
proliferating	adj
proliferation	noun
promethium	noun
promethium-based	adj
promethium-dependent	adj
promoter	noun
promoters	noun
propagation	noun
prostaglandin	noun
prosthetic	adj
prosumer	noun
prosumer	adj
protactinium	noun
protactinium-based	adj
protactinium-dependent	adj
protease	noun
protein	noun
proteolysis	noun
proteome	noun
proteome-wide	adj
proteomes	noun
proteomic	adj
proteomics	noun
Proterozoic	adj
protist	noun
protoplanetary	adj
prototyping	noun
provision	noun
provisory	adj
proximal	adj
pseudo	adj
pseudo-ligands	noun
pseudo-one-dimensional	adj
pseudoexfoliation	noun
pseudogene	noun
Pseudomonas aeruginosa	adj
Pseudomonas aeruginosa	noun
pseudomorphs	noun
pseudorapid	adj
psi	adj
psychophysics	noun
ptarmigan	adj
ptarmigans	noun
pteriomorphian	adj
pyrodiversity	noun
pyrolysis	noun
Python	noun
QoE	noun
quadratic	adj
quanta	noun
quantifiers	noun
quantitative	adj
quantum	adj
quark	noun
quasicrystals	noun
quaternary	adj
quiescent	adj
quinone	noun
quorum-sensing	noun
radar	noun
radars	noun
radiant	adj
radiation	noun
radiations	noun
radiocarbon	adj
radium	noun
radium-based	adj
radium-dependent	adj
radon	noun
radon-based	adj
radon-dependent	adj
ranula	noun
rapid	adj
rate-limiting	adj
rational	adj
reads	noun
reasoner	noun
reboot	noun
recall	noun
recellularized	adj
receptor	noun
recession	noun
recessive	adj
reciprocity	noun
recombinant	adj
recombinase-mediated	adj
recommender	noun
recommenders	noun
reconfigurable	adj
rectus	noun
recursive	adj
recycling	noun
redox	adj
reduction	noun
reductionism	noun
reductionist	adj
redundant	adj
refactoring	noun
refinement	noun
reflection	noun
reflective	adj
reflex	noun
regeneration	noun
regenerative	adj
regolith	noun
regression	noun
regularization	noun
regulatory	adj
regulome	noun
reinforced	adj
relativistic	adj
relativity	noun
relay	noun
relaying	noun
remeshing	noun
remodeled	adj
remodeling	noun
renal	adj
Representationalism	noun
repressor	noun
reproduction	noun
repulsive	adj
repulsor	noun
residuum	noun
resonance	noun
resonator	noun
resonator	noun
resonators	noun
respiratory	adj
responsive	adj
restriction	adj
restriction	noun
reticulate	adj
reticulon	noun
reticulum	noun
retrieval	noun
retrograde	adj
reverberation	noun
rewiring	noun
rewritable	adj
rhenium	noun
rhenium-based	adj
rhenium-dependent	adj
rheumatoid	adj
rhizoid	adj
rhizome	noun
rho	adj
rhodium	noun
rhodium-based	adj
rhodium-dependent	adj
Rhodobacter	adj
Rhodobacter	noun
ribocomputing	noun
ribonucleotide	noun
ribosomal	adj
ribozyme	noun
rigidity	noun
risk	noun
Rnase	noun
robocar	noun
robocars	noun
robot	noun
robust	adj
roentgenium	noun
roentgenium-based	adj
roentgenium-dependent	adj
rotation	noun
routine	noun
rRNA	noun
rubidium	noun
rubidium-based	adj
rubidium-dependent	adj
Rubrivivax gelatinosus	adj
Rubrivivax gelatinosus	noun
Ruby	noun
Ruby on Rails	noun
ruminant	adj
ruminants	noun
ruthenium	noun
ruthenium-based	adj
ruthenium-dependent	adj
rutherfordium	noun
rutherfordium-based	adj
rutherfordium-dependent	adj
SaaS	noun
saccadic	adj
saline	adj
Salmonella enterica	adj
Salmonella enterica	noun
salterprovirus	noun
samarium	noun
samarium-based	adj
samarium-dependent	adj
scaffold	noun
scalable	adj
scandium	noun
scandium-based	adj
scandium-dependent	adj
scanner	noun
scanning	noun
scarcity	noun
scaRNA	noun
scattering	noun
schematic	adj
scholarly	adj
sciatic	adj
seaborgium	noun
seaborgium-based	adj
seaborgium-dependent	adj
seamless	adj
search engine	noun
search engines	noun
sebaceous	adj
second-generation	adj
secondary	adj
sector	noun
sectors	noun
sedimentological	adj
seemingly infinite	adj
segmentation	noun
seismicity	noun
selective	adj
selenium	noun
selenium-based	adj
selenium-dependent	adj
self-directed	adj
self-organizing	adj
self-replicating	adj
self-replication	noun
semantic	adj
semi-automatic	adj
semiconductor	noun
semidefinite	adj
semiphosphorylative	adj
sensorization	noun
sentience	noun
sepsis	noun
sequela	noun
sequelae	noun
sequence	noun
sequencing	noun
sequencing	adj
sequestration	noun
seratonergic	adj
seroconversion	noun
serological	adj
serology	noun
serovar	noun
serum	noun
serum	adj
serum-derived	adj
servo	noun
sewage	noun
sex-linked	adj
sex-ratio	noun
sex-ratios	noun
sexual	adj
shape-modifying	adj
sharing economies	noun
sharing economy	noun
shunt	noun
sialic acid	noun
sigma	adj
signal-based	adj
signaling	adj
significance	noun
silicon	noun
silicon-based	adj
silicon-dependent	adj
silver	noun
silver-based	adj
silver-dependent	adj
simple	adj
simulation	noun
single-pass	adj
singularity	noun
singularity	noun
sintering	noun
siphon	noun
skeuomorphic	adj
SL RNA	noun
smartphone-based	adj
snoRNA	noun
SNP sets	noun
SNPs	noun
snRNA	noun
social	adj
sodium	noun
sodium-based	adj
sodium-dependent	adj
software defined	adj
solenoid-actuated	adj
solvable	adj
solvation	noun
solver	noun
somatic	adj
somatosensory	adj
sonification	noun
Soylent	noun
SPARQL endpoints	noun
spatial	adj
specimen	noun
specimens	noun
spectra	noun
spectral	adj
spectrometry	noun
spectroscopic	adj
spectroscopy	noun
spectrum	noun
speed-up	noun
sperm-typing	noun
spherical	adj
spherical	adj
spheroidal	adj
spillage	noun
spindles	noun
spiracle	noun
spirochete	noun
splenectomy	noun
splenic	adj
splicing	adj
spline	noun
spongiform	adj
spontaneous	adj
sporadic	adj
spotted	adj
sputum	noun
SQL	noun
sRNA	noun
SRP RNA	noun
stability	noun
standards	noun
Staphylococcus	adj
Staphylococcus	noun
Staphylococcus aureus	adj
Staphylococcus aureus	noun
starvation-dependent	adj
state-dependent	adj
statical	adj
statin	noun
statistical	adj
statistics	noun
statolith	noun
steady state	noun
stelar	adj
stent	noun
stereoscopy	noun
steric	adj
sterile	adj
sternal	adj
sterol	noun
stochastic	adj
stoichiometry	noun
stomacher	noun
stop codon	noun
strata	noun
stratification	noun
stratosphere	noun
stratospheric	adj
stratum	noun
streamlined	adj
stress granule	noun
stretchable	adj
stromatolites	noun
strontium	noun
strontium-based	adj
strontium-dependent	adj
Structuralism	noun
structure	noun
structures	noun
sub-bandgap	adj
sub-seafloor	adj
sub-volume	adj
subatomic	adj
subcarrier	noun
subclinical	adj
subdermal	adj
subdural	adj
sublimation	noun
submodular	adj
subset	noun
subsets	noun
subtelomeric	adj
subthalamic	adj
succedent	adj
succession	noun
sulfur	noun
sulfur-based	adj
sulfur-dependent	adj
superalloy	noun
supercapacitor	noun
supercapacitors	noun
superconductor	noun
superconductors	noun
supercurrent	noun
superelasticity	noun
superficial	adj
superfluid	noun
superfluid	adj
superior	adj
superlattice	noun
supernumerary	adj
superorganism	noun
superorganisms	noun
superplastic	adj
supersymmetric	adj
supervisory	adj
support vector machine	noun
suppression	noun
supraluminal	adj
surfactant	noun
surfactants	noun
survey	noun
surveys	noun
Sus scrofa	adj
Sus scrofa	noun
sustainability	noun
swales	noun
swarm	noun
switch	noun
switches	noun
sympatric	adj
symplectic	adj
synchronic	adj
syncope	noun
syndrome	noun
Synechocystis	adj
Synechocystis	noun
synovitis	noun
synthetic	adj
systematic	adj
T cells	noun
tacheometry	noun
tachometer	noun
tachycardia	noun
tachyphylaxis	noun
tagless	adj
tailorable	adj
Takifugu	adj
Takifugu	noun
tandem	adj
tantalum	noun
tantalum-based	adj
tantalum-dependent	adj
target	noun
targeted	adj
targets	noun
tau	adj
taurine	noun
taxonomic	adj
technetium	noun
technetium-based	adj
technetium-dependent	adj
technique	noun
techniques	noun
telencephalic	adj
teleonomy	noun
teleoperation	noun
teleportation	noun
tellurium	noun
tellurium-based	adj
tellurium-dependent	adj
telomere	noun
temporal	adj
tension-based	adj
tensor	noun
tensors	noun
tentative	adj
terbium	noun
terbium-based	adj
terbium-dependent	adj
TERC	noun
terminal	noun
terminals	noun
terraforming	noun
terrestrial	adj
tertiary	adj
tessellated	adj
tessellation	noun
tetherin	noun
tetrad	noun
tetrahydrofuran	noun
tetrahydrofurans	noun
tetramerized	adj
thallium	noun
thallium-based	adj
thallium-dependent	adj
theodolite	noun
theoretic	adj
therapeutic	adj
thermal	adj
thermionic	adj
thermostable	adj
theta	adj
thixomolding	noun
thoracic	adj
thorium	noun
thorium-based	adj
thorium-dependent	adj
three-state	adj
threshold	noun
thrombosis	noun
thrombus	noun
throttling	noun
thulium	adj
thulium	noun
thulium-based	adj
thulium-dependent	adj
time series	noun
tin	noun
tin-based	adj
tin-dependent	adj
titanium	noun
titanium-based	adj
titanium-dependent	adj
tmRNA	noun
TNF-mediated	adj
tolerance	noun
tomography	noun
tone-mapped	adj
toolbox	noun
top-down	adj
topography	noun
topological	adj
topology	noun
topology-preserving	adj
toxic	adj
Toxoplasma gondii	noun
Toxoplasma gondii	adj
tracheae	noun
track-based	adj
trade-offs	noun
tradeoff	noun
transcendence	noun
transcendent	adj
transconductance	noun
transcription	noun
transcription factor	noun
transcription factors	noun
transcriptome	noun
transcriptomic	adj
transcriptomics	noun
transdisciplinary	adj
transduction	noun
transfer	noun
transferase	noun
transfers	noun
transfers	noun
transformable	adj
transformation	noun
transformational	adj
transformations	noun
transformations	noun
transformative	adj
transgene	noun
transgenes	noun
transilluminator	noun
transition	noun
transmissible	adj
transparent	adj
transplantation	noun
transplanted	adj
transposed	adj
triangulation	noun
tribological	adj
trichomoniasis	noun
trigonometry	noun
trinucleotide	adj
tripartite	adj
tripod	noun
tRNA	noun
tropism	noun
troposphere	noun
truncated	adj
truncation	noun
truncations	noun
trust-aware	adj
trypanosomatid	noun
tubular	adj
tumor-suppressor	noun
tunable	adj
tungsten	noun
tungsten-based	adj
tungsten-dependent	adj
turbid	adj
turbulence	noun
turbulent	adj
turnkey	adj
turnover	noun
two-hybrid	adj
two-phase	adj
two-photon	adj
two-process	adj
twofold	adj
typhoid	adj
ubiquitination	noun
ultra-dense	adj
ultrafast	adj
ultraluminous	adj
ultrastable	adj
ultraviolet	adj
umbilical	adj
unateness	noun
unbiased	adj
unbounded	adj
uncertainty	noun
unconference	noun
uncontrolled	adj
unconventional	adj
undocked	adj
unexpressed	adj
ungulate	noun
unhinged	adj
uninterrupted	adj
universal	adj
unnerving	adj
unsupervised	adj
untrained	adj
ununoctium	noun
ununoctium-based	adj
ununoctium-dependent	adj
ununpentium	noun
ununpentium-based	adj
ununpentium-dependent	adj
ununseptium	noun
ununseptium-based	adj
ununseptium-dependent	adj
ununtrium	noun
ununtrium-based	adj
ununtrium-dependent	adj
upconverter	noun
upsilon	adj
uranium	noun
uranium-based	adj
uranium-dependent	adj
Ureaplasma urealyticum	noun
Ureaplasma urealyticum	adj
uremic	adj
uricosurics	noun
urinalysis	noun
urine	noun
urothelial	adj
ursids	noun
ursine	adj
uvaser	noun
vacuole	noun
vacuum	noun
vacuums	noun
vagal	adj
valence	noun
vanadium	noun
vanadium-based	adj
vanadium-dependent	adj
variable	adj
variables	noun
variables	noun
variation	noun
variational	adj
varistor	noun
vascular	adj
vasoactive	adj
vasovagal	adj
vegetative	adj
vehicle	noun
velocity	noun
venereal	adj
ventral	adj
vernalization	noun
Vero cells	noun
vertical	adj
vestigal	adj
vexing	adj
vibrational	adj
Vibrio cholerae	adj
Vibrio cholerae	noun
vibrotactile	adj
viral	adj
viriome	noun
viroid	noun
virophage	noun
virtual reality	adj
virtual reality	noun
virtualization	noun
virtualized	adj
virus	noun
viscoelastic	adj
visible-spectrum	adj
visualization	noun
visualizations	noun
Vitalism	noun
vocal	adj
volatile	adj
voltage-gated	adj
volumetric	adj
vortal	noun
vortex	noun
warpage	noun
wavelet	noun
wavelet-based	adj
wearable	adj
whole exome sequencing	noun
whole genome sequencing	noun
wikis	noun
WiMax	noun
wireless	adj
wobble-pairing	adj
workflow	noun
workload	noun
X-band	adj
xanthelasma	noun
xaser	noun
xenobiological	adj
xenon	noun
xenon-based	adj
xenon-dependent	adj
Xenopus	adj
Xenopus	noun
Xer-exploiting	adj
xeroderma	noun
xi	adj
xiphoid	adj
xylem	noun
xyloglucan	noun
ytterbium	noun
ytterbium-based	adj
ytterbium-dependent	adj
yttrium	noun
yttrium-based	adj
yttrium-dependent	adj
zebrafish	adj
zebrafish	noun
zeta	adj
Zika virus	noun
Zika virus	adj
zinc	noun
zinc-based	adj
zinc-dependent	adj
zirconium	noun
zirconium-based	adj
zirconium-dependent	adj
bystander effect	noun
separase	noun
securin	noun
cannabinoid	noun
stakeholders	noun
distantly-supervised	adj
multistakeholder	adj
cross-modal	adj
tail-tolerant	adj
word vectors	noun
embeddings	noun
regularization	noun
hyperedges	noun
scattering	adj
saliency	noun
salient	adj
thermotaxis	noun
modality	noun
compositionality	noun
self-attention network	noun
LSTMs	noun
monoids	noun
prosopography	noun
end-to-end	adj
multi-pointer	adj
encoder-decoder	adj
multi-factor	adj
